#####################
#         #     #   #
### # # # # ####### #
#   # # #     #     #
####### ######### ###
#   # #   #U  #     #
# ### ### ### ### ###
#       # #   # #   #
# # # ### ### # ### #
# # # #             #
# # # ### ### #######
# # #     # #       #
##### ##### # ### # #
# #   # #   #   # # #
# ### # ### # ### ###
#           #   #   #
#####################