#####################
#       # #         #
# ### ### # ##### # #
# # # # #   #     # #
# # ### ### ####### #
#   # #   #   # #   #
# ### ### ##### ### #
#   # # #         # #
### # # ### ####### #
#   # #       #     #
### # ##### ##### ###
#         # #       #
# # ##### # # #######
# # #   # #       # #
### ### ######### # #
#                   #
#####################