#####################
#         #       # #
# ### ####### ### # #
#   # #   # # # #   #
# # ### ### # # # ###
# #       #   #     #
# # ### ### ####### #
# # # # #   # #     #
### # # ##### # #####
# #   # # #     # # #
# ### # # # ### # # #
#   # # #   # # #   #
# ##### # # # # ### #
# #       #   # #   #
# ### ##### # ### # #
#       #   #     # #
#####################